utility_ID,floor,capacity,tv,board
5,1,3,1,0
6,3,2,1,0
7,2,5,1,0
13,3,3,1,0
14,0,5,1,1
15,1,2,1,1
16,0,5,1,1
17,0,5,0,1
18,0,3,0,0
25,2,3,0,0
26,3,3,0,0
27,1,5,0,1
28,3,5,0,1